1111111111111111
10000C0010000001
10P0000010C10E01
10000C0010010001
1110001111110001
100C000000C00001
10000C0000000001
100000000C001111
10000C0110111001
10000C0000000001
1000000110C00001
11110C0001000001
1000000001000001
100C000001C00001
1111111111111111
