1111111111111111
10000C0000000001
10P0000000C00E01
10000C0000000001
1000000000000001
100C000000C00001
10000C0000000001
100000000C000011
10000C0000000001
10000C0000000001
1000000000C00001
10000C0000000001
1000000000000001
100C000000C00001
1111111111111111
