1111111111111111111111111
10000C0010000000010C00001
10P0000010C10E00010000001
10000C001001000000000C001
1110001111110001110011111
100C000000C00000000000001
10000C000000000C000000001
100000000C001110000100001
10000C0110111000000100001
10000C0000000000000100C01
1000000110C00000010000001
11110C0001000000110000001
100000000100000000100C001
100C000001C00000000100001
1001111001000000C00010001
1000000001011111100001111
100000C001010000100000001
100111100101C010111000001
100C0000010111101000C0001
1000000001000000100000001
1111111111111111111111111
