111111
1C00C1
10P0E1
1C00C1
111111
