1111111111111111111111111
10000C0010000000000000001
10P0000010C10E00000000001
10000C0010010000000000001
1110001111110000000000001
100C000000C00000000000001
10000C0000000000000000001
100000000C001110000000001
10000C0110111000000000001
10000C0000000000000000001
1000000110C00000000000001
11110C0001000000000000001
1000000001000000000000001
100C000001C00000000000001
100C000001C00000000000001
100C000001C00000000000001
100C000001C00000000000001
100C000001C00000000000001
100C000001C00000000000001
100C000001C00000000000001
1111111111111111111111111
