111111
1P0C01
100001
10C0E1
111111
